"a" = (/turf,/area)
"b" = (/turf/forest,/area)
"c" = (/turf/road,/area)
"d" = (/mob/ghost,/turf,/area)
"e" = (/mob/test,/turf,/area)
"f" = (/obj/car,/obj/corpse,/obj/axe,/turf,/area)
"g" = (/mob/test2,/turf,/area)

(1,1,1) = {"
aaaaaaaaaa
bbbaaaaaaa
bbbaaaaaaa
bbbaaaaaaa
acaaaaaaaa
acaaaaaaaa
acaaaaaaaa
acadaaaaaa
aceaaaaaaa
afegaaaaaa
"}
