"a" = (/turf,/area)
"b" = (/turf/forest,/area)
"c" = (/turf/road,/area)
"d" = (/mob/Creature,/turf,/area)
"e" = (/mob/ghost,/turf,/area)
"f" = (/mob/test,/turf,/area)
"g" = (/obj/car,/obj/corpse,/obj/axe,/turf,/area)
"h" = (/mob/test2,/turf,/area)
"i" = (/mob/Creature,/mob/Creature,/turf,/area)

(1,1,1) = {"
aaaaaaaaaa
bbbaaaaaaa
bbbaaaaaaa
bbbaaaaaaa
acaaaaaaaa
acaaaaaaaa
acaaaaadaa
acaeaaaaaa
acfaaaaaaa
dgfhaaiaaa
"}
